#######################################################################################################################################################
#      M                                                                                                                                              #
#                                                                                                                                                     G
#     #################################################################################################################################################
#     #                                                                                                 #                  #     #                    #
#     #   #  ################                                                                           #                  #     ######################
#     #   #  #              #   ##################    ###############################################   #                  ##                         #
#     #   #  ######         #   #    #           #    #                                            ##   #                   #                         #
#     #   #       M    I    #   #    #           #    #                                            ##   #                   #    ######################
#     #   #########         #   #    #           #    #                                            ##   #                   #    #                    #
#     #           ###########   #    #       #####    # #############################################   #                   #    #                    #
#     #   ####                  ######      ##   #    # #    M                                          #                   #    ##                   #
#     #   #  ################   #            #   #    # #   ###################    #####    #########   #                   #     #                   #
#     #   #                 #   #    ######  #   #    # #   #                 #    #   #    #       #########################     ###########         #
#     #   #                 #   #   ##    #  #   #    # #   #                 #    #   #    #                #                              #         #
#     #   #########         #   #   #     #  #   ##   # #   ######            #    #   #    #                #                              ###########
#     #           #         #   #######   ####   ##   # #        ##############    #   #    #    ########    #    ########################            #
#     #           ###########         #   M      ##   # ##       #           #     #   #    #    #      #    #    #                      #            #
#     #########       #     #         ##    ##    #   #  #####   #           #     #   #    #    # ######    #    #                      #########    #
#     #       #####   #     #     ######    ##  M #   #      #   #           #     #   #    #    # #        ##    #                              #    #
#     #           #   #     #     #    M          #   ########   #  ##########    ##  ##    #    # #        #     #                              #    #
#     #  ##########   #     #     #   ######      #          #   #  #             #   #     #    # #   ######     #                              ##   #
#     #  #            #     #     #   #    #      ##       I #   #  #             #   #   ###    # #   #    #     #                               #   #
#     #  #            #     #     #   #    #       ###########   #  #             #   #   #      # #   #    #     #                               #   #
#     #  ##########   #     #    ##   ######                     #  #            ##   #   ##########   ######     #################################   #
#  ####           #   #     #    #        M                      #  ###########  #    #                           #                                   #
#  #              #   #     #    #    ########################   #               #    #                           #                                   #
#  ################   #     #    #    #                      #   ##################################################  ###################   ############
#                     #     #    #    #                      #   #                  #                             #  #                 #   #          #
#######################     #    #    #                      #   #                  #                             #  ##        #####   #   #          #
#                           #    ######  #####################   #                  #                             #   #        #   #   #   #          #
#    ######    #######      #            #                       #                  #                             #   #        #   #   #   #          #
#   ##    #    #     #      #            #               #########                  #                             #   #        #   #####   #          #
#   #     #    #     #     ##########    #   ########    #       #                  #                             #   ##       # I M       #          #
#   #     #    #     #     #       ##    #   #      #    #########                  #                             ##   #       #   #########          #
#   #     #    ##    #    ##       ##    #   #      #            #                  #                              #   #       #   #                  #
#   #     #     #    #    #   I M  ##    #   #      #            #      I     I     #                              #   #       #####                  #
#   #   #####   #    #    #        ##   ##   #      #    #########                  #                              #   #                              #
#   #   #   #   #    #    #######  ##   #    #      #    #       ##########N######################################## M ################################
#   #   #   #   #    #    #     #  ##   #   ##      #    #       #       #   #                                                                        #
#   #   #   #   #    #    #     #   #   #   #       #    #       #   I   #   #    r                                                                   #
#   #   #   #   #    #    #     #   #####   #       #    #       #       #   #                                     ####################################
#   #   #   #   #    #    #     #           #       #    #       #       #   #                                     #                                  #
#   #   #   #   #    #    #     #           #       #    #       #   #####   #                                     #                                  #
#   #   #   #   #    #    #     #############       #    #       #   #   #   #######################################   ################################
#   #   #####   ######    #                         #    #       #   #   #   #      #                                  #                              #
#   #                     #                         #    #       #   #   #   #      #                                  #                              #
#   #################################################    #########   #   #   #      #   ############################   #                              #
#                                                           M        #   #   #      #   #                          #   #          #####################
#                                                        #############   #   #      #   #                          #   #          #                   #
#################################   ####   ##########    #               #   #      #   #                          #   #          #                   #
#                        #      #   #  #   #        #    #               #   #      #   #                          #   #          #   #######   #######
#                        #      #   #  #   #        #    #               #   #      #   #                          #   #          #   #     #   #     #
#   ##################   #      #   #  #   #        #    #               #   #      #   #####################      #   #          #   #     #   #     #
#   #                #   #      #   #  #   #        #    #               #   #      #                       #      #   #          #   #     #   #     #
#   #                #   #      #   #  #   #        #    #               #   #      #                       #      #   #          #   #     #   #######
#   #                #   #      #   #  #   #        #    #               #   #      #####################   #      #   #          #   #######         #
#   #                #   #      #   #  #   #        #    #               #   #                          #   ########   ############   #               #
# M ##########       #   #      #   #  #   #        ######               #   #                          #   #      MMMMMMM        #   #######   #######
#            #       #   #      #   #  #   #                             #   #                          #   #      MMMMMMM        #   #         #     #
#            #       #   #      #   #  #   #                             #   #                          #   #                     #   #         #     #
###########  #       #   ########   ####   ###############################   ############################   #######################   #   ###   #     #
#         #  #       #              #  #                                                                                              #   # #   #     #
#         #  #       #              #  #                                                                                              #   # #   #     #
###########  #       ################  ###################################   ##########################################################   # #####     #
R            #                                                           #   #I                                M                          #           #
#######################################################################################################################################################